72 11
000000000000000000000000000000000000000000000000000000000000000000000000
000000000000000000000000000000000000000000000000000000000000000000000000
000000000000000000000000000000000000000000000000000000000000000000000000
000000000000000000000000000000000000000000000000000000000000000000000000
000000000000000000000000000000000000000000000000000000000000000000000000
000000000000000000000000000000000000000000000000000000000000000000000000
000000000000000000001000000000000000000000000000000000000000000000000000
000000000000000001210100000000000000000000000000000000000000000000000000
000000000000000110000001000000000000000000000000000000000000000000000000
000000000012121000000020120104000000000000000000000000000000000000000000
333333333333333333333333333334333333333333333333333333333333333333333333
